[console_scripts]
wandbox = wandbox.__main__:main
wandbox-CPP = wandbox.__cpp__:main
wandbox-bash = wandbox.__bash__:main
wandbox-cc = wandbox.__cc__:main
wandbox-clang = wandbox.__cc__:clang
wandbox-clang++ = wandbox.__cxx__:clang
wandbox-clang-PP = wandbox.__cpp__:clang
wandbox-cs = wandbox.__csharp__:main
wandbox-cxx = wandbox.__cxx__:main
wandbox-dmd = wandbox.__dmd__:dmd
wandbox-dub = wandbox.__dub__:main
wandbox-elixir = wandbox.__elixir__:main
wandbox-erlang = wandbox.__erlang__:main
wandbox-g++ = wandbox.__cxx__:gcc
wandbox-gcc = wandbox.__cc__:gcc
wandbox-gcc-PP = wandbox.__cpp__:gcc
wandbox-gdmd = wandbox.__dmd__:gdmd
wandbox-ghc = wandbox.__ghc__:main
wandbox-go = wandbox.__go__:main
wandbox-java = wandbox.__java__:main
wandbox-js = wandbox.__js__:main
wandbox-ldmd2 = wandbox.__dmd__:ldmd2
wandbox-mix = wandbox.__elixir__:mix
wandbox-mruby = wandbox.__ruby__:mruby
wandbox-nim = wandbox.__nim__:main
wandbox-node = wandbox.__js__:node
wandbox-perl = wandbox.__perl__:main
wandbox-php = wandbox.__php__:main
wandbox-pypy = wandbox.__python__:pypy
wandbox-python = wandbox.__python__:main
wandbox-python2 = wandbox.__python__:python2
wandbox-python3 = wandbox.__python__:python3
wandbox-ruby = wandbox.__ruby__:main
wandbox-spidermonkey = wandbox.__js__:spidermonkey
wandbox-ssl = wandbox.__openssl__:main
wandbox-stack = wandbox.__ghc__:haskell_stack
wandbox-swift = wandbox.__swift__:main
wandbox-tsc = wandbox.__tsc__:main

