[fedmsg.meta]
anitya = fedmsg_meta_fedora_infrastructure.anitya:AnityaProcessor
ansible = fedmsg_meta_fedora_infrastructure.ansible:AnsibleProcessor
askbot = fedmsg_meta_fedora_infrastructure.askbot:AskbotProcessor
autocloud = fedmsg_meta_fedora_infrastructure.autocloud:AutoCloudProcessor
bodhi = fedmsg_meta_fedora_infrastructure.bodhi:BodhiProcessor
bot = fedmsg_meta_fedora_infrastructure.supybot:SupybotProcessor
bugzilla = fedmsg_meta_fedora_infrastructure.bz:BugzillaProcessor
buildsys = fedmsg_meta_fedora_infrastructure.buildsys:KojiProcessor
ci = fedmsg_meta_fedora_infrastructure.centos_ci:AtomicCiProcessor
comp = fedmsg_meta_fedora_infrastructure.compose:ComposeProcessor
comp2 = fedmsg_meta_fedora_infrastructure.compose2:PungiKojiProcessor
coprs = fedmsg_meta_fedora_infrastructure.coprs:CoprsProcessor
datanommer = fedmsg_meta_fedora_infrastructure.datanommer:DatanommerProcessor
elections = fedmsg_meta_fedora_infrastructure.elections:ElectionsProcessor
faf = fedmsg_meta_fedora_infrastructure.faf:FAFProcessor
fas = fedmsg_meta_fedora_infrastructure.fas:FASProcessor
fedbadges = fedmsg_meta_fedora_infrastructure.badges:BadgesProcessor
fedimg = fedmsg_meta_fedora_infrastructure.fedimg:FedimgProcessor
fedocal = fedmsg_meta_fedora_infrastructure.fedocal:FedocalProcessor
fmn = fedmsg_meta_fedora_infrastructure.fmn:FMNProcessor
github = fedmsg_meta_fedora_infrastructure.github:GithubProcessor
gw = fedmsg_meta_fedora_infrastructure.greenwave:GreenwaveProcessor
hotness = fedmsg_meta_fedora_infrastructure.hotness:HotnessProcessor
infragit = fedmsg_meta_fedora_infrastructure.infragit:InfraGitProcessor
irc = fedmsg_meta_fedora_infrastructure.karma:KarmaProcessor
jenkins = fedmsg_meta_fedora_infrastructure.jenkins:JenkinsProcessor
kerneltest = fedmsg_meta_fedora_infrastructure.kerneltest:KernelTestProcessor
koschei = fedmsg_meta_fedora_infrastructure.koschei:KoscheiProcessor
mailman = fedmsg_meta_fedora_infrastructure.mailman3:MailmanProcessor
mbs = fedmsg_meta_fedora_infrastructure.mbs:MBSProcessor
mdapi = fedmsg_meta_fedora_infrastructure.mdapi:MdapiProcessor
mm2 = fedmsg_meta_fedora_infrastructure.mm2:MirrorManagerProcessor
nagios = fedmsg_meta_fedora_infrastructure.nagios:NagiosProcessor
nuancier = fedmsg_meta_fedora_infrastructure.nuancier:NuancierProcessor
odcs = fedmsg_meta_fedora_infrastructure.odcs:ODCSProcessor
old_allpackages_ci = fedmsg_meta_fedora_infrastructure.centos_ci:OldAllpackagesCiProcessor
old_container_ci = fedmsg_meta_fedora_infrastructure.centos_ci:OldContainerCiProcessor
openqa = fedmsg_meta_fedora_infrastructure.openqa:OpenQAProcessor
pagure = fedmsg_meta_fedora_infrastructure.pagure:PagureProcessor
pagure_distgit = fedmsg_meta_fedora_infrastructure.pagure:DistGitPagureProcessor
pdc = fedmsg_meta_fedora_infrastructure.pdc:PDCProcessor
pkgdb = fedmsg_meta_fedora_infrastructure.pkgdb:PkgdbProcessor
planet = fedmsg_meta_fedora_infrastructure.planet:PlanetProcessor
rats = fedmsg_meta_fedora_infrastructure.rats:RatsProcessor
releng = fedmsg_meta_fedora_infrastructure.releng:RelengProcessor
scm = fedmsg_meta_fedora_infrastructure.scm:SCMProcessor
summershum = fedmsg_meta_fedora_infrastructure.summershum:SummerShumProcessor
tagger = fedmsg_meta_fedora_infrastructure.tagger:TaggerProcessor
taskotron = fedmsg_meta_fedora_infrastructure.taskotron:TaskotronProcessor
trac = fedmsg_meta_fedora_infrastructure.trac:TracProcessor
waiverdb = fedmsg_meta_fedora_infrastructure.waiverdb:WaiverDBProcessor
wiki = fedmsg_meta_fedora_infrastructure.mediawiki:WikiProcessor
zanata = fedmsg_meta_fedora_infrastructure.zanata:ZanataProcessor

