[console_scripts]
create-app = foremast.app.__main__:main
create-configs = foremast.configs.__main__:main
create-dns = foremast.dns.__main__:main
create-elb = foremast.elb.__main__:main
create-iam = foremast.iam.__main__:main
create-pipeline = foremast.pipeline.__main__:main
create-s3 = foremast.s3.__main__:main
create-scaling-policy = foremast.runner:create_scaling_policy
create-sg = foremast.securitygroup.__main__:main
destroy-dns = foremast.dns.destroy_dns.__main__:main
destroy-elb = foremast.elb.destroy_elb.__main__:main
destroy-iam = foremast.iam.destroy_iam.__main__:main
destroy-s3 = foremast.s3.destroy_s3.__main__:main
destroy-sg = foremast.securitygroup.destroy_sg.__main__:main
foremast = foremast.__main__:main
foremast-deploy-s3app = foremast.runner:deploy_s3app
foremast-infrastructure = foremast.runner:prepare_infrastructure
foremast-pipeline = foremast.runner:prepare_app_pipeline
foremast-pipeline-onetime = foremast.runner:prepare_onetime_pipeline
foremast-pipeline-rebuild = foremast.runner:rebuild_pipelines
foremast-promote-s3app = foremast.runner:promote_s3app
foremast-scaling-policy = foremast.runner:create_scaling_policy
foremast-scheduled-actions = foremast.runner:create_scheduled_actions
full-destroy = foremast.destroyer:main
prepare-app-pipeline = foremast.runner:prepare_app_pipeline
prepare-infrastructure = foremast.runner:prepare_infrastructure
prepare-onetime-pipeline = foremast.runner:prepare_onetime_pipeline
rebuild_pipelines = foremast.runner:rebuild_pipelines
slack-notify = foremast.slacknotify.__main__:main

